29
*
29
*
1
*
00-1-0
#
01-1-26
#
02-1-67
#
03-1-90
#
04-1-88
#
05-1-68
#
06-1-111
#
07-1-66
#
08-1-112
#
09-1-110
#
10-1-44
#
11-1-45
#
12-1-11
#
13-1-12
#
14-1-13
#
15-1-14
#
16-1-15
#
17-1-33
#
18-1-34
#
19-1-35
#
20-1-36
#
21-1-37
#
22-1-27
#
23-1-58
#
24-1-246
#
25-1-247
#
26-1-266
#
27-1-267
#
28-1-268
#
29-1-269
#
30-1-289
#
31-1-290
#
32-1-291
#
33-1-311
#
34-1-312
#
35-1-313
#
36-1-333
#
37-1-334
#
38-1-335
#
39-1-248
#
40-1-249
#
41-1-270
#
42-1-271
#
43-1-258
#
44-1-236
#
45-1-232
#
46-1-233
#
47-1-234
#
48-1-210
#
49-1-211
#
50-1-212
#
51-1-188
#
52-1-189
#
53-1-190
#
54-1-166
#
55-1-167
#
56-1-168
#
57-1-144
#
58-1-145
#
59-1-146
#
60-1-122
#
61-1-123
#
62-1-124
#
62-1-213
#
63-1-191
#
64-1-215
#
65-1-193
#
66-1-214
#
67-1-192
#
68-1-121
*
11111111111111111111111111111
11111111111111111111111111111
11111111111111111111111111111
11111111110101011111111111111
11111111110101011111111111111
11100011100000011111000111111
00000000000000011000000000000
00000000000000000000000000000
00000000000000000000000000000
00000000000000000000000000000
00000000000000111000000000000
00000000000000111000000000000
00000000000000111000000000000
00000000000000111000000000000
00000000000000111000000000000
00000000000000111000000000000
00110000000000111000000000000
11110000000000111000000000000
01110000000000111000000000000
01110000000000111000000000000
01110000000000111000000000000
00000000000000111000000000000
00000000000000111000000000000
00000000000000000000000000000
00000000000000000000000000000
00000000000000000001111111000
00000000000000000001111111000
11111111100000000000111110000
11111111100000000000000000000
*
60 61 62 68 68 68 60 61 62 68 68 68 68 68 68 68 68 60 61 62 68 68 68 60 61 62 60 61 62
57 58 59 61 61 61 57 58 59 61 61 61 61 61 61 61 61 57 58 59 61 61 61 57 58 59 57 58 59
54 55 56 58 58 58 54 55 56 58 58 58 58 58 58 58 58 54 55 56 58 58 58 54 55 56 54 55 56
51 52 53 63 65 63 51 52 53 63 67 65 67 65 67 65 63 51 52 53 63 65 63 51 52 53 51 52 53
48 49 50 62 64 62 48 49 50 62 66 64 66 64 66 64 62 48 49 50 62 64 62 48 49 50 48 49 50
45 46 47 00 00 00 45 46 47 00 44 44 44 44 44 39 40 45 46 47 00 00 00 45 46 47 45 46 47
01 01 01 01 01 01 01 01 01 00 44 44 44 44 44 41 42 01 01 01 01 01 01 01 01 01 01 01 01
01 01 01 01 01 01 01 01 01 00 43 43 43 43 43 00 00 01 01 01 01 01 01 01 01 01 01 01 01
01 01 01 01 01 01 01 01 01 00 00 00 00 00 00 00 00 01 01 01 01 01 01 01 01 01 01 01 01
01 01 01 01 01 01 01 01 01 00 00 00 00 00 00 00 00 01 01 01 01 01 01 01 01 01 01 01 01
01 01 01 01 01 01 01 01 01 00 00 00 00 00 07 02 05 01 01 01 01 01 01 01 01 01 01 01 01
00 00 00 00 00 00 00 00 00 00 00 00 00 00 04 00 03 01 01 01 01 01 01 01 01 01 01 01 01
00 00 00 00 00 00 00 00 00 00 00 00 00 00 04 00 03 01 01 01 01 01 01 01 01 01 01 01 01
00 00 00 00 00 00 00 00 00 00 00 00 00 00 04 00 03 00 00 00 00 00 00 00 00 00 00 00 00
01 01 01 01 01 01 01 01 01 00 00 00 00 00 04 00 03 01 01 01 01 01 01 01 00 00 00 00 00
01 01 01 01 01 01 01 01 01 00 00 00 00 00 04 00 03 01 01 01 01 01 01 01 00 00 00 00 00
00 00 24 25 01 01 01 01 01 01 01 01 01 01 04 00 03 01 01 01 01 01 01 01 00 00 00 00 00
26 27 28 29 01 01 01 01 01 01 01 01 01 01 04 00 03 01 01 01 01 01 01 01 00 00 00 00 00
00 30 31 32 01 01 01 01 01 01 01 01 01 01 04 00 03 01 01 01 01 01 01 01 00 00 00 00 00
00 33 34 35 01 01 01 01 01 01 01 01 01 01 04 00 03 01 01 01 01 01 01 01 00 00 00 00 00
00 36 37 38 01 01 01 01 01 01 01 01 01 01 04 00 03 01 01 01 01 01 01 01 00 00 00 00 00
00 00 00 00 00 01 01 01 01 01 01 01 01 01 04 00 03 01 01 01 01 01 01 01 00 00 00 00 00
00 00 00 00 00 01 01 01 01 01 01 01 01 01 09 06 08 01 01 01 01 01 01 01 00 00 00 00 00
00 01 01 01 01 01 01 01 01 01 01 01 01 01 01 01 01 01 01 01 01 01 01 01 00 00 00 00 00
00 01 01 01 01 01 01 01 01 01 01 01 01 01 01 01 01 00 00 00 00 00 00 00 00 00 00 00 00
00 00 00 00 00 00 00 00 00 00 00 00 00 00 00 00 00 00 00 12 13 14 14 14 15 16 00 00 00
00 00 00 00 00 00 00 00 00 00 00 00 00 00 00 00 00 00 00 17 18 19 19 19 20 21 00 00 00
02 02 02 02 02 02 02 02 05 00 00 00 00 00 00 00 00 00 00 00 22 23 22 22 22 00 00 00 00
00 00 00 00 00 00 00 00 03 00 00 10 11 00 00 00 00 00 00 00 00 00 00 00 00 00 00 00 00
*
11-27
*
12-5-05.txt