16
*
16
*
1
*
00-1-158
#
01-1-114
#
02-1-92
#
03-1-113
#
04-1-91
#
05-1-184
#
06-1-185
#
07-1-162
#
08-1-163
#
09-1-136
#
10-1-97
#
11-1-98
#
12-1-119
#
13-1-120
#
14-1-184
#
15-1-185
#
16-1-254
#
17-1-255
#
18-1-256
#
19-1-257
#
20-1-276
#
21-1-277
#
22-1-278
#
23-1-279
#
24-1-298
#
25-1-299
#
26-1-300
#
27-1-301
*
1111111111111111
1111111111111111
1111111111111111
0000000110000000
0000000000000000
0000000000000000
0000000000000000
0000110000110000
0000110000110000
0000000000000000
0000000000000000
0000000000000000
0000000000000000
0000000000000000
0000000000000000
0000000000000000
*
02 02 04 02 02 04 02 02 02 02 04 02 02 04 02 02
01 01 03 01 01 03 01 10 11 01 03 01 01 03 01 01
01 01 01 01 01 01 01 12 13 01 01 01 01 01 01 01
00 00 00 00 07 09 09 14 15 09 09 08 00 00 00 00
00 00 00 00 07 09 09 09 09 09 09 08 00 00 00 00
00 00 00 00 07 09 09 09 09 09 09 08 00 00 00 00
00 00 00 00 07 09 09 09 09 09 09 08 00 00 00 00
00 00 00 00 16 17 00 07 08 00 18 19 00 00 00 00
00 00 00 00 20 21 00 07 08 00 22 23 00 00 00 00
00 00 00 00 24 25 00 07 08 00 26 27 00 00 00 00
00 00 00 00 00 00 00 07 08 00 00 00 00 00 00 00
00 00 00 00 00 00 00 07 08 00 00 00 00 00 00 00
00 00 00 00 00 00 00 07 08 00 00 00 00 00 00 00
00 00 00 00 00 00 00 07 08 00 00 00 00 00 00 00
00 00 00 00 00 00 00 07 08 00 00 00 00 00 00 00
00 00 00 00 00 00 00 05 06 00 00 00 00 00 00 00
*
8-15
*
8-3-01.txt